Проверка: Ошибка для проверки

ОКР-ОШ-ЧТЕНИЕ-ИСХОДНОГО: Ошибка чтения исходного файла '$;': $;
ОКР-ОШ-ПУТЬ: Неверный путь '$;':  $;
ОКР-НЕ-ПАПКА: Путь '$;' должен указывать на папку: $;
ОКР-ОШ-НЕТ-ИСХОДНИКОВ: Нет исходников для компиляции: '$;'
ОКР-ОШ-РАСШИРЕНИЕ: Неверное расширение файла '$;', должно быть: $;

ОКР-ОШ-ПУТЬ-ИМПОРТА: Неверный путь импорта '$;':  $;
ОКР-ИМПОРТ-НЕ-ПАПКА: Путь импорта '$;' должен указывать на папку: $;
ОКР-ИМПОРТ-ПУСТАЯ-ПАПКА: Путь в импорте '$;' указывает на папку '$;', в которой нет исходных файлов
ОКР-ОШ-ИМЯ-МОДУЛЯ: Имя модуля '$;' не совпадает с именем папки '$;'

ОКР-ОШ-МОДУЛИ-В-ПАПКЕ: Модули '$;' и '$;' в одной папке: $;

//ОКР-ТЕСТ-ПУСТАЯ-ПАПКА: Путь для команды тестирования '$;' указывает на папку '$;', в которой нет исходных файлов
ОКР-ОШ-НЕТ-ТЕСТОВ: Нет тестов для тестируемого модуля. Нет папки или нет исходных файлов: '$;'
ОКР-НЕТ-ТЕСТ-ВХОДА: Нет найден исходники входа для тестирования '$;': '$;'

ЛЕК-ОШ-СИМ: Недопустимый символ: $;
ЛЕК-UTF8: Ошибка в UTF-8 кодировке
ЛЕК-МОДИФИКАТОР: Неверный модификатор
ЛЕК-НЕТ-*/: Блочный комментарий не завершен
ЛЕК-СТРОКА-ЗАВЕРШЕНИЕ: Нет завершающей кавычки у строкового или символьного литерала
ЛЕК-ОШ-ДЛИНА-СИМВОЛА: В символьном литерале должен быть ровно один символ
ЛЕК-ESCAPE-ЗАВЕРШЕНИЕ: Escape-последовательность не завершена
ЛЕК-ОШ-ESCAPE: Необрабатываемая escape-последовательность
ЛЕК-ВЕЩ-БАЗА: Вещественный литерал должен быть десятичным

ПАР-ОЖИДАЛСЯ: Ожидалась лексема '$;'
ПАР-ДУБЛЬ-ВХОД: Вход в модуле может быть только один, см: $;
ПАР-ОШ-ОПИСАНИЕ: Описание не может начинаться с лексемы '$;'
ПАР-ОШ-РАЗД: Ожидался разделитель ';' или NL, а не '$;' 
ПАР-ОШ-ОПЕРАТОР: Оператор не может начинаться с лексемы '$;'
ПАР-ОШ-МОДИФИКАТОР: Непригодный модификатор: '$;'
ПАР-ОШ-МОД-АТРИБУТ: Непригодный атрибут модификатора: '$;'
ПАР-ОШ-ОПЕРАНД: Неверный операнд: '$;'
ПАР-ОШ-КОНСТ-БАЗА: Значение базовой константы должно быть целым литералом
ПАР-ОШ-ЛИТЕРАЛ: Ошибка получения значения литерала: $;
//не используется ПАР-ОШ-ОП-ТИПА: Ошибочное описание типа, начинающееся с лексемы '$;'
ПАР-СМЕСЬ-МАССИВ: Недопустимая смесь пар и значений в композите массива
ПАР-ПЕРЕМ-ИНИТ: Отсутствует обязательная инициализация переменной или поля
ПАР-МЕСТО-ВАРИАДИК: Вариативный параметр (...Т) должен быть последним в списке параметров
ПАР-ОШ-ИСП-ОСТОРОЖНО: Использование небезопасной операции (с меткой 'осторожно') без метки у в заголовке модуля
ПАР-ОШ-ОСТОРОЖНО-НЕ-ИСП: Исходный текст помечен меткой 'осторожно', но осторожные операции не использованы

СЕМ-ЦИКЛ-ИМПОРТА: Циклический импорт. Модуль '$;' прямо или косвенно импортирует сам себя.
СЕМ-МОДУЛЬ-НЕ-ИМПОРТИРОВАН: Нет импорта модуля '$;' в файле '$;'

СЕМ-УЖЕ-ОПИСАНО: Объект с именем '$;' уже есть в текущей область видимости
СЕМ-НЕ-НАЙДЕНО: Объект с именем '$;' не найден
СЕМ-НЕ-НАЙДЕН-МОДУЛЬ: Модуль '$;' не найден
СЕМ-НЕ-НАЙДЕНО-В-МОДУЛЕ: В модуле '$;' не найден объект с именем '$;'
СЕМ-ДОЛЖЕН-БЫТЬ-МОДУЛЬ: Объект по имени '$;' не обозначает модуль
СЕМ-ДОЛЖЕН-БЫТЬ-ТИП: Объект по имени '$;' не обозначает тип
СЕМ-НЕ-ЭКСПОРТИРОВАН: Объект '$;' не экспортирован из модуля '$;'
СЕМ-НЕ-НАЙДЕН-МЕТОД-ВЕКТОРА: Метод '$;' не является стандартным методом вектора
СЕМ-РЕКУРСИВНОЕ-ОПРЕДЕЛЕНИЕ: Рекурсивное определение объекта: '$;'

СЕМ-ДЛЯ-ПОЗЖЕ-НУЖЕН-ТИП: Для переменной или поля с поздней инициализацией тип должен быть задан
СЕМ-НЕТ-ПОЗЖЕ-ПОЛЯ: Значение поля '$;' с поздней инициализацией должно быть задано
СЕМ-ПОЗЖЕ-ЛОК-ПЕРЕМЕННАЯ: Поздняя инициализация не может быть задана для локальной переменной

СЕМ-МБ-ТИП-НЕ-ССЫЛКА: Тип 'может-быть' должен строится на основе ссылочного типа, а не '$;'
СЕМ-ОЖИДАЛСЯ-МБ-ТИП: Выражение должно быть 'может-быть' типа, а не '$;'

СЕМ-ПОЛУЧАТЕЛЬ-НЕ-КЛАСС: Получатель метода должен быть классом
СЕМ-БАЗА-НЕ-КЛАСС: Базовый тип класса должен быть классом
СЕМ-ДУБЛЬ-В-КЛАССЕ: В классе уже определено поле или метод с именем '$;', см. $;
СЕМ-РАЗНЫЕ-ТИПЫ-МЕТОДОВ: Типы при перепределении метода '$;' не совпадают: $;
СЕМ-ТИП-ВЫРАЖЕНИЯ: Тип выражения должен быть '$;'
СЕМ-ВЫЗОВ-НЕ-ФУНКТИП: Неверный тип у вызова ($;), должен быть тип функции
СЕМ-ЧИСЛО-АРГУМЕНТОВ: Число аргументов вызова: $;, должно быть $;
СЕМ-ВЫХОДНОй-ТИПЫ-НЕ-РАВНЫ: Тип аргумента должен быть эквивалентен типу выходного параметра
СЕМ-ВАРИАДИК-ЧИСЛО-АРГУМЕНТОВ: Число аргументов вызова этой вариативной функции не может быть меньше $;, задано $;
СЕМ-РАЗВОРАЧИВАНИЕ-ТОЛЬКО-ВАРИАДИК: Оператор разворачивания '...' применим только для для аргумента вариативной функции
СЕМ-ВАРИАТИВНЫЙ-ВЫХОДНОЙ: Вариативный параметр не может быть выходным
СЕМ-ОДНО-РАЗВОРАЧИВАНИЕ: Оператор разворачивания применим к единственному аргументу
СЕМ-ТИПЫ-ЭЛЕМЕНТОВ-НЕ-СОВПАДАЮТ: Типы элементов в операторе разворачивания должны совпадать: '$;' и '$;'

СЕМ-ФН-НЕТ-ЗНАЧЕНИЯ: Функцию без результата нельзя использовать в позиции значения
СЕМ-НЕСОВМЕСТИМО-ПРИСВ: Выражение не совместимо по присваиванию $;: '$;' := '$;'
СЕМ-ОШ-ТИП-ОПЕРАНДА: Недопустимый тип операнда '$;' для операции '$;'
СЕМ-ОПЕРАНДЫ-НЕ-СОВМЕСТИМЫ: Типы операндов не совместимы: '$;' $; '$;'
СЕМ-ОШ-УНАРНАЯ-ТИП: Неверный тип операнда '$;' для унарной операции '$;'
СЕМ-ОШ-ВЕРНУТЬ-ЛИШНЕЕ: В этом операторе 'вернуть' не должно быть выражения
СЕМ-ОШ-ВЕРНУТЬ-НУЖНО: В этом операторе 'вернуть' должно быть выражение
СЕМ-НЕТ-ВЕРНУТЬ: Пропущен оператор 'вернуть'
СЕМ-ПРЕРВАТЬ-ВНЕ-ЦИКЛА: Оператор 'прервать' должен быть в цикле
СЕМ-ЗНАЧЕНИЕ-НЕ-ИСПОЛЬЗУЕТСЯ: Значение выражения не используется
СЕМ-ОЖИДАЛОСЬ-ПРИСВАИВАНИЕ: Ожидалось присваивание  ':='
СЕМ-НЕ-ЗАВЕРШАЮЩИЙ: Последний оператор должен быть завершающим (вернуть, прервать, авария)
СЕМ-ВЫБОР-ОШ-ТИП: Недопустимый тип выражения в операторе выбора: '$;'
СЕМ-ВЫБОР-ОШ-ТИП-ВАРИАНТА: Тип варианта и тип входного выражения должны совпадать: '$;' и '$;'
СЕМ-ВЫБОР-ОШ-ТИП-ПРЕДИКАТА: Тип варианта в предикатном выборе должен быть '$;', а не '$;'
СЕМ-ВЫБОР-ТИП-КЛАССА: Выражение в операторе выбора по типу должно быть типа класс, а не '$;'
СЕМ-ВЫБОР-ОДИН-ТИП: В операторе выбора по типу с переменной в варианте должен быть только один тип

СЕМ-КОНСТРУКТОР-НЕТ-ТИПА: Конструктор должен начинаться с типа
СЕМ-КОН-ВЕКТОРА-ОШ-ТИП: Тип в конструкторе вектора должен быть индексируемого типа
СЕМ-КОН-ВЕКТОРА-НЕТ-УМОЛЧАНИЯ: В этом конструкторе должно быть задано значение по умолчанию (*: Значение)
СЕМ-КОН-ВЕКТОРА-ОШ-ДЛИНА: Длина векторе должна быть не отрицательная
СЕМ-КОН-ВЕКТОРА-ИНДЕКС-ДИАП: Индекс должен быть в диапазоне [0..$;], а равен: $;
СЕМ-КОН-ВЕКТОРА-ИНДЕКС-ДУБЛЬ: Индекс $; уже использовался в позиции: $;
//СЕМ-МАССИВ-КОМПОЗИТ-ТИП-КЛЮЧА: Ключ в композите массива должен быть целого типа
СЕМ-ОЖИДАЛСЯ-ТИП-МАССИВА: Должен быть массив, вместо него '$;'
СЕМ-ОШ-ТИП-РАЗВЕРНУТЬ: Должен быть вектор, вместо него '$;'
СЕМ-ОШ-ТИП-ИНДЕКСА: Тип индекса должен быть целым, а не '$;'

СЕМ-КЛАСС-КОМПОЗИТ-ОШ-ТИП: Тип в конструкторе класса должен быть типом класса
СЕМ-КЛАСС-КОМПОЗИТ-НЕТ-ПОЛЯ: В классе нет поля с именем '$;'
СЕМ-КЛАСС-КОМПОЗИТ-НЕ-ПОЛE: Ожидалось поле, а не метод
СЕМ-ОЖИДАЛСЯ-ТИП-КЛАССА: Должен быть тип класса, вместо него '$;'
СЕМ-ОЖИДАЛОСЬ-ПОЛЕ-ИЛИ-МЕТОД: В классе нет поля или метода с именем '$;'
СЕМ-ДОЛЖЕН-БЫТЬ-НАСЛЕДНИКОМ: Класс '$;' должен быть наследником класса '$;' 
СЕМ-ОПЕРАЦИЯ-ТИПА: Операнд у операции 'типа' должен быть классом или может-быть классом, а не '$;'

СЕМ-ОШ-КОНСТ-ВЫРАЖЕНИЕ: Должно быть константное выражение
СЕМ-НЕ-ПРИСВОИТЬ: Не может быть левой частью присваивания (литерал, константа, конструктор или переменная с единственным присваиванием)
СЕМ-ТИП-В-ВЫРАЖЕНИИ: Тип не может быть использован в этом выражении

СЕМ-СТДФУНК-ОШ-ЧИСЛО-АРГ: Неверное число аргументов в вызове стд. функции '$;', должно быть: $;
СЕМ-СТД-ДЛИНА-ОШ-ТИП-АРГ: Неверный тип аргумента в вызове стд. функции '$;', должен быть вектор или вариативный параметр или Строка
СЕМ-СТД-ТЕГ-ОШ-АРГ: Должен быть тип или значение полиморфного типа (п: *) 
СЕМ-СТД-НЕЧТО-ОШ-АРГ: Только для параметра типа '*'
// не используется в трик:
СЕМ-СОХРАНЕНИЕ-ПОЛИМОРФНОГО: Не реализовано: сохранение значения полиморфного параметра в переменную

СЕМ-ОШ-ПРИВЕДЕНИЯ-ТИПА: Недопустимое приведение типа '$;' к типу '$;'
СЕМ-ОШ-ОСТОРОЖНОГО-ПРИВЕДЕНИЯ: Осторожное приведение типа '$;' к типу '$;' не разрешено
СЕМ-ПРИВЕДЕНИЕ-ТИПА-К-СЕБЕ: Лишнее приведение типа, тип и так уже '$;'
СЕМ-ЗНАЧЕНИЕ-НЕ-В-ДИАПАЗОНЕ: Значение выходит за диапазон для типа '$;'
СЕМ-ДЛИНА-СТРОКИ-НЕ-1: Строковый литерал здесь должен из одного символа

ГЕН-ОШ-КОНФ-ФАЙЛА: Ошибка чтения конфигурационного файла генерации: $;
ГЕН-ОШ-НАСТРОЙКА: В конфигурационном файле '$;' не задана настройка для '$;'
ГЕН-ОШ-СБОРКА: Ошибка в выполнении сборки:  $;/$;